 Fighter 
 Stats: 10 HP, 1 STR, 0 INT. 
 Inventory: {Short Sword} of {Attack}. 

 Mage 
 Stats: 5 HP, 0 STR, 1 INT. 
 Inventory: {+2} {Pink Spellbook} of {Fire}.

>l
It is written in the Book of Ishtar: 

 After the Creation, the cruel god Moloch rebelled against the authority of Marduk the Creator. Bla bla bla... 

 Who reads the stories anyway? Go get the Amulet of Yendor and come back out alive!

test
A BoardHack dungeon by Alexandre Laplante
Entrance
As you enter the dungeon, the doorway behind disappears.

You can see a lizard and a wizard here.

>l
Entrance
As you enter the dungeon, the doorway behind disappears.

You can see a lizard and a wizard here.

{{{ "room": "Entrance", "things": "yourself, lizard, wizard and big door", "directions": "north, south, east and west", "actions": "go, take, identify, examine, damage", "choices": "0" }}}

>look
hello

>loooook
That's not a verb I recognise.

* * *

>l
Entrance
As you enter the dungeon, the doorway behind disappears.

You can see a lizard and a wizard here.

{{{ "room": "Entrance", "things": "yourself, lizard, wizard and big door", "directions": "north, south, east and west", "actions": "go, take, identify, examine, damage", "choices": "0" }}}

>l
Entrance
As you enter the dungeon, the doorway behind disappears.

You can see a lizard and a wizard here.

{{{ room: "Entrance", things: "yourself, lizard, wizard and big door", directions: "north, south, east and west", actions: "go, take, identify, examine, damage", choices: "0", }}}

>s
You can't go that way.

{{{ things: "yourself, lizard, wizard and big door", directions: "north, south, east and west", actions: "go, take, identify, examine, damage", choices: "0", }}}

>l
Entrance
As you enter the dungeon, the doorway behind disappears.

You can see a lizard and a wizard here.

{{{ things: "yourself, lizard, wizard and big door", directions: "north, south, east and west", actions: "go, take, identify, examine, damage", choices: "0", }}}

>s
You can't go that way.

{{{ things: "yourself, lizard, wizard and big door", directions: "north, south, east and west", actions: "go, take, identify, examine, damage", choices: "0", }}}

* * *

>l
Entrance
As you enter the dungeon, the doorway behind disappears.

You can see a lizard and a wizard here.

{{{ things: "yourself, lizard, wizard and big door", directions: "north, south, east and west", actions: "go, take, identify, examine, damage", choices: "0", }}}

>x
What do you want to examine?

>x
What do you want to examine?

* * *

>l
Entrance
As you enter the dungeon, the doorway behind disappears.

You can see a lizard and a wizard here.

{{{ room: "Entrance", things: "yourself, lizard, wizard and big door", directions: "north, south, east and west", actions: "go, take, identify, examine, damage", choices: "0", }}}

>l
Entrance
As you enter the dungeon, the doorway behind disappears.

You can see a lizard and a wizard here.

{{{ things: "yourself, lizard, wizard and big door", directions: "north, south, east and west", actions: "go, take, identify, examine, damage", choices: "0", }}}

>l
Entrance
As you enter the dungeon, the doorway behind disappears.

You can see a lizard and a wizard here.

{{{ things: "yourself, lizard, wizard and big door", directions: "north, south, east and west", actions: "go, take, identify, examine, damage", choices: "0", }}}

* * *

>l
Entrance
As you enter the dungeon, the doorway behind disappears.

You can see a lizard and a wizard here.

{{{ room: "Entrance", things: "yourself, lizard, wizard and big door", directions: "north, south, east and west", actions: "go, take, identify, examine, damage", choices: "0", }}}

>i
You are carrying nothing.

{{{ room: "Entrance", things: "yourself, lizard, wizard and big door", directions: "north, south, east and west", actions: "go, take, identify, examine, damage", choices: "0", }}}

>id
What do you want to id?

>id Entrance
That noun did not make sense in this context.

>id location
That noun did not make sense in this context.

>id .
That noun did not make sense in this context.

>id lizard
A weak looking lizard. 5/5 HP 0 STR 0 INT.

{{{ room: "Entrance", things: "yourself, lizard, wizard and big door", directions: "north, south, east and west", actions: "go, take, identify, examine, damage", choices: "0", }}}

>id lizard
A weak looking lizard. 5/5 HP 0 STR 0 INT.

{{{ room: "Entrance", things: "yourself, lizard, wizard and big door", directions: "north, south, east and west", actions: "go, take, identify, examine, damage", choices: "0", }}}

* * *

>l
It is written in the Book of Ishtar: 

 After the Creation, the cruel god Moloch rebelled against the authority of Marduk the Creator. Bla bla bla... 

 Who reads the stories anyway? Go get the Amulet of Yendor and come back out alive!

test
A BoardHack dungeon by Alexandre Laplante
Entrance
As you enter the dungeon, the doorway behind disappears.

You can see a lizard and a wizard here.

>s
Intro2
You can go north to Intro from here.

>n
Intro
You can go south to Intro2 from here.

>l
Intro
You can go south to Intro2 from here.

>x monster
You can't see any such thing.

* * *

>l
It is written in the Book of Ishtar: 

 After the Creation, the cruel god Moloch rebelled against the authority of Marduk the Creator. Bla bla bla... 

 Who reads the stories anyway? Go get the Amulet of Yendor and come back out alive!

test
A BoardHack dungeon by Alexandre Laplante
Entrance
As you enter the dungeon, the doorway behind disappears.

You can see a lizard and a wizard here.

>x
(the monster)
Universe #1

>x world
You can't see any such thing.

>x the world
You can't see any such thing.

* * *

>l
It is written in the Book of Ishtar: 

 After the Creation, the cruel god Moloch rebelled against the authority of Marduk the Creator. Bla bla bla... 

 Who reads the stories anyway? Go get the Amulet of Yendor and come back out alive!

test
A BoardHack dungeon by Alexandre Laplante
Entrance
As you enter the dungeon, the doorway behind disappears.

You can see a lizard and a wizard here.

>x floor
You can't see any such thing.

* * *

>l
It is written in the Book of Ishtar: 

 After the Creation, the cruel god Moloch rebelled against the authority of Marduk the Creator. Bla bla bla... 

 Who reads the stories anyway? Go get the Amulet of Yendor and come back out alive!

test
A BoardHack dungeon by Alexandre Laplante
Entrance
As you enter the dungeon, the doorway behind disappears.

You can see a lizard and a wizard here.

>x monster
A giant scadbeast

{{{things: "yourself, monster and floor"}}}
{{{directions: "north, south, east and west"}}}
{{{actions: "take, identify"}}}

>x yourself
As good-looking as ever.

{{{things: "yourself, monster and floor"}}}
{{{directions: "north, northeast, northwest, south, southeast, southwest, east, west, up, down, inside and outside"}}}

>x n
You see nothing unexpected in that direction.

{{{things: "yourself, monster and floor"}}}
{{{directions: "north, northeast, northwest, south, southeast, southwest, east, west, up, down, inside and outside"}}}

* * *

>x monster
A giant scadbeast

{{{things: "yourself, monster and floor"}}}
{{{directions: "north, south, east and west"}}}
{{{actions: "take, identify"}}}

>talk to monster
That's not a verb I recognise.

* * *

>l
It is written in the Book of Ishtar: 

 After the Creation, the cruel god Moloch rebelled against the authority of Marduk the Creator. Bla bla bla... 

 Who reads the stories anyway? Go get the Amulet of Yendor and come back out alive!

test
A BoardHack dungeon by Alexandre Laplante
Entrance
As you enter the dungeon, the doorway behind disappears.

You can see a lizard and a wizard here.

>identify
That's not a verb I recognise.

* * *

>l
It is written in the Book of Ishtar: 

 After the Creation, the cruel god Moloch rebelled against the authority of Marduk the Creator. Bla bla bla... 

 Who reads the stories anyway? Go get the Amulet of Yendor and come back out alive!

test
A BoardHack dungeon by Alexandre Laplante
Entrance
As you enter the dungeon, the doorway behind disappears.

You can see a lizard and a wizard here.

>x self
As good-looking as ever.

{{{things: "yourself, monster and floor"}}}
{{{directions: "north, south, east and west"}}}
{{{actions: "take, identify"}}}

* * *

>l
It is written in the Book of Ishtar: 

 After the Creation, the cruel god Moloch rebelled against the authority of Marduk the Creator. Bla bla bla... 

 Who reads the stories anyway? Go get the Amulet of Yendor and come back out alive!

test
A BoardHack dungeon by Alexandre Laplante
Entrance
As you enter the dungeon, the doorway behind disappears.

You can see a lizard and a wizard here.

>x lizard
You see nothing special about the Lizard.

{{{things: "yourself, Lizard and floor"}}}
{{{directions: "north, south, east and west"}}}
{{{actions: "take, identify"}}}

* * *

>l
It is written in the Book of Ishtar: 

 After the Creation, the cruel god Moloch rebelled against the authority of Marduk the Creator. Bla bla bla... 

 Who reads the stories anyway? Go get the Amulet of Yendor and come back out alive!

test
A BoardHack dungeon by Alexandre Laplante
Entrance
As you enter the dungeon, the doorway behind disappears.

You can see a lizard and a wizard here.

>take north
You must name something more substantial.

{{{things: "yourself, lizard and floor"}}}
{{{directions: "north, south, east and west"}}}
{{{actions: "go, take, identify, examine"}}}

>id north
{{{things: "yourself, lizard and floor"}}}
{{{directions: "north, south, east and west"}}}
{{{actions: "go, take, identify, examine"}}}

>id north
{{{things: "yourself, lizard and floor"}}}
{{{directions: "north, south, east and west"}}}
{{{actions: "go, take, identify, examine"}}}

* * *

>l
It is written in the Book of Ishtar: 

 After the Creation, the cruel god Moloch rebelled against the authority of Marduk the Creator. Bla bla bla... 

 Who reads the stories anyway? Go get the Amulet of Yendor and come back out alive!

test
A BoardHack dungeon by Alexandre Laplante
Entrance
As you enter the dungeon, the doorway behind disappears.

You can see a lizard and a wizard here.

>1
That's not a verb I recognise.

>2
That's not a verb I recognise.

>3
That's not a verb I recognise.

>4
That's not a verb I recognise.

>5
That's not a verb I recognise.

>6
That's not a verb I recognise.

>l
Entrance
This is the only real room in the world. welcome.

You can see a lizard and a wizard here.

{{{things: "yourself, lizard, wizard and floor"}}}
{{{directions: "north, south, east and west"}}}
{{{actions: "go, take, identify, examine, damage"}}}

* * *

>l
It is written in the Book of Ishtar: 

 After the Creation, the cruel god Moloch rebelled against the authority of Marduk the Creator. Bla bla bla... 

 Who reads the stories anyway? Go get the Amulet of Yendor and come back out alive!

test
A BoardHack dungeon by Alexandre Laplante
Entrance
As you enter the dungeon, the doorway behind disappears.

You can see a lizard and a wizard here.

>n
Shop
There is a merchant here who is offering you a choice of items. Your party can only afford one. Will you buy the red potion or the yellow potion?

You can see a merchant here.

>l
Shop
There is a merchant here who is offering you a choice of items. You can only afford one. Will you buy the red potion or the yellow potion?

You can see a merchant here.

{{{things: "yourself, lizard, wizard, floor and merchant"}}}
{{{directions: "north, south, east and west"}}}
{{{actions: "go, take, identify, examine, damage"}}}
{{{choices: "2"}}}

>1
you choose 1
{{{things: "yourself, lizard, wizard, floor and merchant"}}}
{{{directions: "north, south, east and west"}}}
{{{actions: "go, take, identify, examine, damage"}}}
{{{choices: "2"}}}

>s
Entrance
As you enter the dungeon, the doorway behind disappears.

You can see a lizard and a wizard here.

{{{things: "yourself, lizard, wizard, floor and merchant"}}}
{{{directions: "north, south, east and west"}}}
{{{actions: "go, take, identify, examine, damage"}}}
{{{choices: "2"}}}

>l
Entrance
As you enter the dungeon, the doorway behind disappears.

You can see a lizard and a wizard here.

{{{things: "yourself, lizard, wizard, floor and merchant"}}}
{{{directions: "north, south, east and west"}}}
{{{actions: "go, take, identify, examine, damage"}}}
{{{choices: "2"}}}

>2
{{{things: "yourself, lizard, wizard, floor and merchant"}}}
{{{directions: "north, south, east and west"}}}
{{{actions: "go, take, identify, examine, damage"}}}
{{{choices: "0"}}}

* * *

>l
Shop
There is a merchant here who is offering you a choice of items. You can only afford one. Will you buy the red potion or the yellow potion?

You can see a merchant here.

{{{things: "yourself, lizard, wizard, floor and merchant"}}}
{{{directions: "north, south, east and west"}}}
{{{actions: "go, take, identify, examine, damage"}}}
{{{choices: "2"}}}

>4
{{{things: "yourself, lizard, wizard, floor and merchant"}}}
{{{directions: "north, south, east and west"}}}
{{{actions: "go, take, identify, examine, damage"}}}
{{{choices: "0"}}}

>l
Shop
There is a merchant here who is offering you a choice of items. You can only afford one. Will you buy the red potion or the yellow potion?

You can see a merchant here.

{{{things: "yourself, lizard, wizard, floor and merchant"}}}
{{{directions: "north, south, east and west"}}}
{{{actions: "go, take, identify, examine, damage"}}}
{{{choices: "0"}}}

>s
Entrance
As you enter the dungeon, the doorway behind disappears.

You can see a lizard and a wizard here.

{{{things: "yourself, lizard, wizard, floor and merchant"}}}
{{{directions: "north, south, east and west"}}}
{{{actions: "go, take, identify, examine, damage"}}}
{{{choices: "0"}}}

>n
{{{things: "yourself, lizard, wizard, floor and merchant"}}}
{{{directions: "north, south, east and west"}}}
{{{actions: "go, take, identify, examine, damage"}}}
{{{choices: "2"}}}

* * *

>l
It is written in the Book of Ishtar: 

 After the Creation, the cruel god Moloch rebelled against the authority of Marduk the Creator. Bla bla bla... 

 Who reads the stories anyway? Go get the Amulet of Yendor and come back out alive!

test
A BoardHack dungeon by Alexandre Laplante
Entrance
As you enter the dungeon, the doorway behind disappears.

You can see a lizard and a wizard here.

>id lizard
A weak looking lizard. 5/5 HP 0 STR 0 INT.

{{{things: "yourself, lizard, wizard and big door"}}}
{{{directions: "north, south, east and west"}}}
{{{actions: "go, take, identify, examine, damage"}}}
{{{choices: "0"}}}

>id wizard
A powerful looking wizard. 10/10 HP 0 STR 0 INT.

{{{things: "yourself, lizard, wizard and big door"}}}
{{{directions: "north, south, east and west"}}}
{{{actions: "go, take, identify, examine, damage"}}}
{{{choices: "0"}}}

>id north
You see nothing unexpected in that direction.

{{{things: "yourself, lizard, wizard and big door"}}}
{{{directions: "north, south, east and west"}}}
{{{actions: "go, take, identify, examine, damage"}}}
{{{choices: "0"}}}

>id big door
There is no way out of here.
{{{things: "yourself, lizard, wizard and big door"}}}
{{{directions: "north, south, east and west"}}}
{{{actions: "go, take, identify, examine, damage"}}}
{{{choices: "0"}}}

>id door
There is no way out of here.
{{{things: "yourself, lizard, wizard and big door"}}}
{{{directions: "north, south, east and west"}}}
{{{actions: "go, take, identify, examine, damage"}}}
{{{choices: "0"}}}

>1
{{{things: "yourself, lizard, wizard and big door"}}}
{{{directions: "north, south, east and west"}}}
{{{actions: "go, take, identify, examine, damage"}}}
{{{choices: "0"}}}

* * *

>l
It is written in the Book of Ishtar: 

 After the Creation, the cruel god Moloch rebelled against the authority of Marduk the Creator. Bla bla bla... 

 Who reads the stories anyway? Go get the Amulet of Yendor and come back out alive!

test
A BoardHack dungeon by Alexandre Laplante
Entrance
As you enter the dungeon, the doorway behind disappears.

You can see a lizard and a wizard here.

>x w
You see nothing unexpected in that direction.

{{{ things: "yourself, lizard, wizard and big door", directions: "north, south, east and west", actions: "go, take, identify, examine, damage", choices: "0", }}}

>x wi
You can't see any such thing.

>x wiz
You can't see any such thing.

* * *

>l
It is written in the Book of Ishtar: 

 After the Creation, the cruel god Moloch rebelled against the authority of Marduk the Creator. Bla bla bla... 

 Who reads the stories anyway? Go get the Amulet of Yendor and come back out alive!

test
A BoardHack dungeon by Alexandre Laplante
Entrance
As you enter the dungeon, the doorway behind disappears.

You can see a lizard and a wizard here.

I beg your pardon?

>l
Entrance
As you enter the dungeon, the doorway behind disappears.

You can see a lizard and a wizard here.

{{{ "room": "Entrance", "things": "yourself, lizard, wizard and big door", "directions": "north, south, east, west and around", "actions": "look, go, take, identify, damage", "choices": "0" }}}

* * *

 Fighter 
 Stats: 10 HP, 1 STR, 0 INT. 
 Inventory: {Short Sword} of {Attack}. 

 Mage 
 Stats: 5 HP, 0 STR, 1 INT. 
 Inventory: {+2} {Pink Spellbook} of {Fire}.

>y
(exits listing is on)
test
An Interactive Fiction by Alexandre Laplante
Release 1 / Serial number 141015 / Inform 7 build 6G60 (I6/v6.32 lib 6/12N) SD

hello 9:00 am true

>l
hello 9:00 am true

>s
Intro2
You can go north from here.

>n
Intro
You can go south to Intro2 from here.

>s
Intro2
You can go north to Intro from here.

* * *

 Fighter 
 Stats: 10 HP, 1 STR, 0 INT. 
 Inventory: {Short Sword} of {Attack}. 

 Mage 
 Stats: 5 HP, 0 STR, 1 INT. 
 Inventory: {+2} {Pink Spellbook} of {Fire}.

>s
Intro2
You can go north to Intro from here.

{{{yourself and monster}}}

>n
Intro
You can go south to Intro2 from here.

I beg your pardon?

>l
Intro
You can go south to Intro2 from here.

* * *

>s
Intro2
You can go north to Intro from here.

{{{yourself and monster}}}

I beg your pardon?

>n
Intro
This is the only real room in the world.

Whoa a monster!

You can go south to Intro2 from here.

{{{yourself and monster}}}

* * *

 Fighter 
 Stats: 10 HP, 1 STR, 0 INT. 
 Inventory: {Short Sword} of {Attack}. 

 Mage 
 Stats: 5 HP, 0 STR, 1 INT. 
 Inventory: {+2} {Pink Spellbook} of {Fire}.

>x
(the Lizard)
A weak looking Lizard. 5

{{{things: "yourself, Lizard and floor"}}}
{{{directions: "north, south, east and west"}}}
{{{actions: "take, identify"}}}

>t
That's not a verb I recognise.

>take
(the monster)
Taken.

>drop
(the monster)
Dropped.

* * *

>x
(the Lizard)
A weak looking Lizard. 5

{{{things: "yourself, Lizard and floor"}}}
{{{directions: "north, south, east and west"}}}
{{{actions: "take, identify"}}}

>i
You are carrying nothing.

{{{things: "yourself, Lizard and floor"}}}
{{{directions: "north, south, east and west"}}}
{{{actions: "take, identify"}}}

>id
(the Lizard)
You can see everything interesting about the Lizard already.
{{{things: "yourself, Lizard and floor"}}}
{{{directions: "north, south, east and west"}}}
{{{actions: "take, identify"}}}

>take yourself
You are always self-possessed.

{{{things: "yourself, Lizard and floor"}}}
{{{directions: "north, south, east and west"}}}
{{{actions: "take, identify"}}}

>identify yourself
You can see everything interesting about yourself already.
{{{things: "yourself, Lizard and floor"}}}
{{{directions: "north, south, east and west"}}}
{{{actions: "take, identify"}}}

>identify thief
That noun did not make sense in this context.

* * *

 Fighter 
 Stats: 10 HP, 1 STR, 0 INT. 
 Inventory: {Short Sword} of {Attack}. 

 Mage 
 Stats: 5 HP, 0 STR, 1 INT. 
 Inventory: {+2} {Pink Spellbook} of {Fire}.

>x floor
You can't see any such thing.

* * *

 Fighter 
 Stats: 10 HP, 1 STR, 0 INT. 
 Inventory: {Short Sword} of {Attack}. 

 Mage 
 Stats: 5 HP, 0 STR, 1 INT. 
 Inventory: {+2} {Pink Spellbook} of {Fire}.

>z
Time passes.

{{{yourself, monster and floor}}}

* * *

 Fighter 
 Stats: 10 HP, 1 STR, 0 INT. 
 Inventory: {Short Sword} of {Attack}. 

 Mage 
 Stats: 5 HP, 0 STR, 1 INT. 
 Inventory: {+2} {Pink Spellbook} of {Fire}.

>x lizard
A weak looking lizard.

{{{things: "yourself, lizard, wizard and floor"}}}
{{{directions: "north, south, east and west"}}}
{{{actions: "go, take, identify, examine, damage"}}}

>take lizard
I don't suppose the Lizard would care for that.

{{{things: "yourself, Lizard and floor"}}}
{{{directions: "north, south, east and west"}}}
{{{actions: "take, identify"}}}

>id lizard
You can see everything interesting about the Lizard already.
{{{things: "yourself, Lizard and floor"}}}
{{{directions: "north, south, east and west"}}}
{{{actions: "take, identify"}}}

* * *

>x lizard
A weak looking lizard.

{{{things: "yourself, lizard, wizard and floor"}}}
{{{directions: "north, south, east and west"}}}
{{{actions: "go, take, identify, examine, damage"}}}

>id lizard
A weak looking Lizard. 5/5 HP 0 STR 0 INT
{{{things: "yourself, lizard and floor"}}}
{{{directions: "north, south, east and west"}}}
{{{actions: "take, identify"}}}

>id self
You can see everything interesting about yourself already.
{{{things: "yourself, lizard and floor"}}}
{{{directions: "north, south, east and west"}}}
{{{actions: "take, identify"}}}

* * *

>x lizard
A weak looking lizard.

{{{things: "yourself, lizard, wizard and floor"}}}
{{{directions: "north, south, east and west"}}}
{{{actions: "go, take, identify, examine, damage"}}}

>x self
As good-looking as ever.

{{{things: "yourself, lizard and floor"}}}
{{{directions: "north, south, east and west"}}}
{{{actions: "go, take, identify, examine"}}}

>id self
As good-looking as ever.
{{{things: "yourself, lizard and floor"}}}
{{{directions: "north, south, east and west"}}}
{{{actions: "go, take, identify, examine"}}}

>id north
That noun did not make sense in this context.

* * *

>x lizard
A weak looking lizard.

{{{things: "yourself, lizard, wizard and floor"}}}
{{{directions: "north, south, east and west"}}}
{{{actions: "go, take, identify, examine, damage"}}}

>x wizard
A powerful looking wizard.

{{{things: "yourself, lizard, wizard and floor"}}}
{{{directions: "north, south, east and west"}}}
{{{actions: "go, take, identify, examine, damage"}}}

>damage wizard by 4
{{{things: "yourself, lizard, wizard and floor"}}}
{{{directions: "north, south, east and west"}}}
{{{actions: "go, take, identify, examine, damage"}}}

* * *

 Fighter 
 Stats: 10 HP, 1 STR, 0 INT. 
 Inventory: {Short Sword} of {Attack}. 

 Mage 
 Stats: 5 HP, 0 STR, 1 INT. 
 Inventory: {+2} {Pink Spellbook} of {Fire}.

>identify lizard
{{{things: "yourself, Lizard and floor"}}}
{{{directions: "north, south, east and west"}}}
{{{actions: "take, identify"}}}

* * *

 Fighter 
 Stats: 10 HP, 1 STR, 0 INT. 
 Inventory: {Short Sword} of {Attack}. 

 Mage 
 Stats: 5 HP, 0 STR, 1 INT. 
 Inventory: {+2} {Pink Spellbook} of {Fire}.

>identidy lizard
That's not a verb I recognise.

>identify lizard
You can see everything interesting about the Lizard already.
{{{things: "yourself, Lizard and floor"}}}
{{{directions: "north, south, east and west"}}}
{{{actions: "take, identify"}}}

* * *

 Fighter 
 Stats: 10 HP, 1 STR, 0 INT. 
 Inventory: {Short Sword} of {Attack}. 

 Mage 
 Stats: 5 HP, 0 STR, 1 INT. 
 Inventory: {+2} {Pink Spellbook} of {Fire}.

>id
(the lizard)
A weak looking Lizard. 5/5 HP 0 STR 0 INT
{{{things: "yourself, lizard and floor"}}}
{{{directions: "north, south, east and west"}}}
{{{actions: "take, identify, examine"}}}

>id floor
You can see everything interesting about the floor already.
{{{things: "yourself, Lizard and floor"}}}
{{{directions: "north, south, east and west"}}}
{{{actions: "take, identify"}}}

>id myself
You can see everything interesting about yourself already.
{{{things: "yourself, Lizard and floor"}}}
{{{directions: "north, south, east and west"}}}
{{{actions: "take, identify"}}}

* * *

>id
(the lizard)
A weak looking Lizard. 5/5 HP 0 STR 0 INT
{{{things: "yourself, lizard and floor"}}}
{{{directions: "north, south, east and west"}}}
{{{actions: "take, identify, examine"}}}

>x
(the lizard)
A weak looking Lizard.

{{{things: "yourself, lizard and floor"}}}
{{{directions: "north, south, east and west"}}}
{{{actions: "take, identify, examine"}}}

>id north
That noun did not make sense in this context.

>l north
You see nothing unexpected in that direction.

{{{things: "yourself, lizard and floor"}}}
{{{directions: "north, south, east and west"}}}
{{{actions: "take, identify, examine"}}}

>l lizard
A weak looking Lizard.

{{{things: "yourself, lizard and floor"}}}
{{{directions: "north, south, east and west"}}}
{{{actions: "take, identify, examine"}}}

>x north
You see nothing unexpected in that direction.

{{{things: "yourself, lizard and floor"}}}
{{{directions: "north, south, east and west"}}}
{{{actions: "take, identify, examine"}}}

* * *

 Fighter 
 Stats: 10 HP, 1 STR, 0 INT. 
 Inventory: {Short Sword} of {Attack}. 

 Mage 
 Stats: 5 HP, 0 STR, 1 INT. 
 Inventory: {+2} {Pink Spellbook} of {Fire}.

>x self
As good-looking as ever.

>x you
You can't see any such thing.

>x thief
You can't see any such thing.

>id thief
That noun did not make sense in this context.

>id self
You can see everything interesting about yourself already.
{{{things: "yourself, Lizard and floor"}}}
{{{directions: "north, south, east and west"}}}
{{{actions: "take, identify"}}}

* * *

>x self
As good-looking as ever.

>l
Entrance
As you enter the dungeon, the doorway behind disappears.

You can see a lizard and a wizard here.

* * *

>s
Entrance
As you enter the dungeon, the doorway behind disappears.

You can see a lizard and a wizard here.

>l
Entrance
As you enter the dungeon, the doorway behind disappears.

You can see a lizard and a wizard here.

>l
Entrance
As you enter the dungeon, the doorway behind disappears.

You can see a lizard and a wizard here.

* * *

>n
You can't go that way.

>s
Entrance
As you enter the dungeon, the doorway behind disappears.

You can see a lizard and a wizard here.

* * *

>go south
Entrance
As you enter the dungeon, the doorway behind disappears.

You can see a lizard and a wizard here.

* * *

 Fighter 
 Stats: 10 HP, 1 STR, 0 INT. 
 Inventory: {Short Sword} of {Attack}. 

 Mage 
 Stats: 5 HP, 0 STR, 1 INT. 
 Inventory: {+2} {Pink Spellbook} of {Fire}.

{{{"images": [ ], "room": "Entrance", "things": "yourself and doorway", "party": "Fighter and Mage", "directions": "north and west", "actions": "look, go, identify, damage", "choices": [ ] }}}
It is written in the Book of Ishtar: 

 After the Creation, the cruel god Moloch rebelled against the authority of Marduk the Creator. Bla bla bla... 

 Who reads the stories anyway? Go get the Amulet of Yendor and come back out alive!

>l
Entrance
As you enter the dungeon, the doorway behind disappears.

You can see a lizard and a wizard here.

{{{things: "yourself, lizard, wizard, floor and merchant"}}}
{{{directions: "north, south, east and west"}}}
{{{actions: "go, take, identify, examine, damage"}}}
{{{choices: "0"}}}

>n
Room2
{{{things: "yourself, lizard and floor"}}}
{{{directions: "north, south, east and west"}}}
{{{actions: "take, identify, examine"}}}

>take lizard
You can't see any such thing.

>s
Entrance
This is the only real room in the world. welcome.

You can see a lizard here.

{{{things: "yourself, lizard and floor"}}}
{{{directions: "north, south, east and west"}}}
{{{actions: "take, identify, examine"}}}

* * *

{{{"images": [ ], "room": "Entrance", "things": "yourself and doorway", "party": "Fighter and Mage", "directions": "north and west", "actions": "look, go, identify, damage", "choices": [ ] }}}
It is written in the Book of Ishtar: 

 After the Creation, the cruel god Moloch rebelled against the authority of Marduk the Creator. Bla bla bla... 

 Who reads the stories anyway? Go get the Amulet of Yendor and come back out alive!

>1
{{{things: "yourself, lizard, wizard, floor and merchant"}}}
{{{directions: "north, south, east and west"}}}
{{{actions: "go, take, identify, examine, damage"}}}

>n
Shop
There is a merchant here who is offering you a choice of items. You can only afford one. Will you buy the red potion or the yellow potion?

You can see a merchant here.

{{{things: "yourself, lizard, wizard, floor and merchant"}}}
{{{directions: "north, south, east and west"}}}
{{{actions: "go, take, identify, examine, damage"}}}

>1
you choose 1
{{{things: "yourself, lizard, wizard, floor and merchant"}}}
{{{directions: "north, south, east and west"}}}
{{{actions: "go, take, identify, examine, damage"}}}

* * *

{{{"images": [ ], "room": "Entrance", "things": "yourself and doorway", "party": "Fighter and Mage", "directions": "north and west", "actions": "look, go, identify, damage", "choices": [ ] }}}
It is written in the Book of Ishtar: 

 After the Creation, the cruel god Moloch rebelled against the authority of Marduk the Creator. Bla bla bla... 

 Who reads the stories anyway? Go get the Amulet of Yendor and come back out alive!

>yes
It is written in the Book of Ishtar: 

 After the Creation, the cruel god Moloch rebelled against the authority of Marduk the Creator. Bla bla bla... 

 Who reads the stories anyway? Go get the Amulet of Yendor and come back out alive!

test
A BoardHack dungeon by Alexandre Laplante
Entrance
As you enter the dungeon, the doorway behind disappears.

You can see a lizard and a wizard here.

* * *

{{{"images": [ ], "room": "Entrance", "things": "yourself and doorway", "party": "Fighter and Mage", "directions": "north and west", "actions": "look, go, identify, damage", "choices": [ ] }}}
It is written in the Book of Ishtar: 

 After the Creation, the cruel god Moloch rebelled against the authority of Marduk the Creator. Bla bla bla... 

 Who reads the stories anyway? Go get the Amulet of Yendor and come back out alive!

>hello
I didn't understand that number.

Continue

* * *

{{{"images": [ ], "room": "Entrance", "things": "yourself and doorway", "party": "Fighter and Mage", "directions": "north and west", "actions": "look, go, identify, damage", "choices": [ ] }}}
It is written in the Book of Ishtar: 

 After the Creation, the cruel god Moloch rebelled against the authority of Marduk the Creator. Bla bla bla... 

 Who reads the stories anyway? Go get the Amulet of Yendor and come back out alive!

Entrance
As you enter the dungeon, the doorway shuts and is sealed tight by a magical force. To the west is the chest room. To the north there is a shop.

>look around
Entrance
As you enter the dungeon, the doorway shuts and is sealed tight by a magical force.

You can see a lizard and a wizard here.

{{{ "room": "Entrance", "things": "yourself, lizard, wizard and doorway", "directions": "north, south, east and west", "actions": "look, go, identify, damage", "choices": "0" }}}

>look
Entrance
As you enter the dungeon, the doorway shuts and is sealed tight by a magical force.

You can see a lizard and a wizard here.

{{{ "room": "Entrance", "things": "yourself, lizard, wizard and doorway", "directions": "north, south, east and west", "actions": "look, go, identify, damage", "choices": "0" }}}

* * *

Entrance
As you enter the dungeon, the doorway shuts and is sealed tight by a magical force. To the west is the chest room. To the north there is a shop.

>l
Entrance
As you enter the dungeon, the doorway shuts and is sealed tight by a magical force. To the west is the chest room. To the north there is a shop.

{{{"images": [ ], "room": "Entrance", "things": "yourself and doorway", "party": "Fighter and Mage", "directions": "north and west", "actions": "look, go, identify, damage", "choices": [ ] }}}

>n
Shop
This is the shop. To the south is the entrance to the dungeon. There is a merchant here who is offering you a choice of items. Your party can only afford one. Will you buy the Red Potion or the Yellow Potion?

You can see a merchant here.

{{{"images": [{ "name": "merchant", "file": "HumanThief2", "desc": "You don't want to mess with this guy." } ], "room": "Shop", "things": "yourself, merchant, Red Potion and Yellow Potion", "party": "Fighter and Mage", "directions": "south", "actions": "look, go, identify, damage", "choices": [ { "name": "c1", "desc": "Take the Red Potion" },{ "name": "c2", "desc": "Take the Yellow Potion" }] }}}

I beg your pardon?

I beg your pardon?

>l
Shop
This is the shop. To the south is the entrance of the dungeon. There is a merchant here who is offering you a choice of items. Your party can only afford one. Will you buy the red potion or the yellow potion?

You can see a merchant here.

{{{"images": [{ "name": "merchant", "file": "HumanThief2", "desc": "You don't want to mess with this guy." } ], "room": "Shop", "things": "yourself and merchant", "party": "Fighter and Mage", "directions": "south", "actions": "look, go, identify, damage", "choices": "take the first potion" }}}

>take the first potion
That's hardly portable.

{{{"images": [{ "name": "merchant", "file": "HumanThief2", "desc": "You don't want to mess with this guy." } ], "room": "Shop", "things": "yourself and merchant", "party": "Fighter and Mage", "directions": "south", "actions": "look, go, identify, damage", "choices": "take the first potion" }}}

* * *

>choose c1
The mage gets the {Red Potion}.

{{{"images": [{ "name": "merchant", "file": "HumanThief2", "desc": "You don't want to mess with this guy." } ], "room": "Shop", "things": "yourself and merchant", "party": "Fighter and Mage", "directions": "south", "actions": "look, go, identify, damage", "choices": [ ] }}}

* * *

>choose c2
The mage gets the {Yellow Potion}.

{{{"images": [{ "name": "merchant", "file": "HumanThief2", "desc": "You don't want to mess with this guy." } ], "room": "Shop", "things": "yourself and merchant", "party": "Fighter and Mage", "directions": "south", "actions": "look, go, identify, damage", "choices": [ ] }}}

* * *

>x merchant
You don't want to mess with this guy.

{{{"images": [{ "name": "merchant", "file": "HumanThief2", "desc": "You don't want to mess with this guy." } ], "room": "Shop", "things": "yourself, merchant and Red Potion", "party": "Fighter and Mage", "directions": "south", "actions": "look, go, identify, damage", "choices": [ { "name": "c1", "desc": "Take the Red Potion" },{ "name": "c2", "desc": "Take the Yellow Potion" }] }}}

* * *

>l
Shop
This is the shop. To the south is the entrance to the dungeon. There is a merchant here who is offering you a choice of items. Your party can only afford one. Will you buy the Red Potion or the Yellow Potion?

You can see a merchant here.

{{{"images": [{ "name": "merchant", "file": "HumanThief2", "desc": "You don't want to mess with this guy." } ], "room": "Shop", "things": "yourself, merchant, Red Potion and Yellow Potion", "party": "Fighter and Mage", "directions": "south", "actions": "look, go, identify, damage", "choices": [ { "name": "c1", "desc": "Take the Red Potion" },{ "name": "c2", "desc": "Take the Yellow Potion" }] }}}

>x yellow potion
You see nothing special about the Yellow Potion.

{{{"images": [{ "name": "merchant", "file": "HumanThief2", "desc": "You don't want to mess with this guy." } ], "room": "Shop", "things": "yourself, merchant, Red Potion and Yellow Potion", "party": "Fighter and Mage", "directions": "south", "actions": "look, go, identify, damage", "choices": [ { "name": "c1", "desc": "Take the Red Potion" },{ "name": "c2", "desc": "Take the Yellow Potion" }] }}}

>id yellow potion
You see nothing special about the Yellow Potion.

{{{"images": [{ "name": "merchant", "file": "HumanThief2", "desc": "You don't want to mess with this guy." } ], "room": "Shop", "things": "yourself, merchant, Red Potion and Yellow Potion", "party": "Fighter and Mage", "directions": "south", "actions": "look, go, identify, damage", "choices": [ { "name": "c1", "desc": "Take the Red Potion" },{ "name": "c2", "desc": "Take the Yellow Potion" }] }}}

>take yellow potion
That seems to belong to the merchant.

{{{"images": [{ "name": "merchant", "file": "HumanThief2", "desc": "You don't want to mess with this guy." } ], "room": "Shop", "things": "yourself, merchant, Red Potion and Yellow Potion", "party": "Fighter and Mage", "directions": "south", "actions": "look, go, identify, damage", "choices": [ { "name": "c1", "desc": "Take the Red Potion" },{ "name": "c2", "desc": "Take the Yellow Potion" }] }}}

>damage merchant by 10
The merchant takes 10 damage.
The merchant is enraged by your unprovoked attack!
The merchant has been slain!
The merchant dropped Red Potion and Yellow Potion.
The Mage picks up {Red Potion}.
The Fighter picks up {Yellow Potion}.

{{{"images": [ ], "room": "Shop", "things": "yourself, Red Potion and Yellow Potion", "party": "Fighter and Mage", "directions": "south", "actions": "look, go, identify, damage", "choices": [ { "name": "c1", "desc": "Take the Red Potion" },{ "name": "c2", "desc": "Take the Yellow Potion" }] }}}

>i
You are carrying:
  a Yellow Potion
  a Red Potion

{{{"images": [ ], "room": "Shop", "things": "yourself, Red Potion and Yellow Potion", "party": "Fighter and Mage", "directions": "south", "actions": "look, go, identify, damage", "choices": [ { "name": "c1", "desc": "Take the Red Potion" },{ "name": "c2", "desc": "Take the Yellow Potion" }] }}}

* * *

Entrance
As you enter the dungeon, the doorway shuts and is sealed tight by a magical force. To the west is the chest room. To the north there is a shop.

I beg your pardon?

>l
Entrance
As you enter the dungeon, the doorway shuts and is sealed tight by a magical force. To the west is the chest room. To the north there is a shop.

{{{"images": [ ], "room": "Entrance", "things": "yourself and doorway", "party": "fighter and mage", "directions": "north, south, east and west", "actions": "look, go, identify, damage", "choices": "0" }}}

>w
Chest room
The treasure chest calls to you. To the west is the entrance of this dungeon.

You can see a lizard and a wizard here.

{{{"images": [{ "name": "lizard", "file": "LizardRed", "desc": "A weak looking lizard." },{ "name": "wizard", "file": "HumanMage2", "desc": "A powerful looking wizard." } ], "room": "Chest room", "things": "yourself, lizard and wizard", "party": "fighter and mage", "directions": "north, south, east and west", "actions": "look, go, identify, damage", "choices": "0" }}}
The lizard hits the mage for 1 point of damage!

>e
You can't go there because the lizard is attacking you!

{{{"images": [{ "name": "lizard", "file": "LizardRed", "desc": "A weak looking lizard." },{ "name": "wizard", "file": "HumanMage2", "desc": "A powerful looking wizard." } ], "room": "Chest room", "things": "yourself, lizard and wizard", "party": "fighter and mage", "directions": "north, south, east and west", "actions": "look, go, identify, damage", "choices": "0" }}}
The lizard hits the mage for 1 point of damage!

>damage wizard by 1
The wizard takes 1 damage.
The wizard is enraged by your unprovoked attack!

{{{"images": [{ "name": "lizard", "file": "LizardRed", "desc": "A weak looking lizard." },{ "name": "wizard", "file": "HumanMage2", "desc": "A powerful looking wizard." } ], "room": "Chest room", "things": "yourself, lizard and wizard", "party": "fighter and mage", "directions": "north, south, east and west", "actions": "look, go, identify, damage", "choices": "0" }}}
The lizard hits the mage for 1 point of damage!
The wizard hits the fighter for 1 point of damage!

>e
You can't go there because the lizard and the wizard is attacking you!

{{{"images": [{ "name": "lizard", "file": "LizardRed", "desc": "A weak looking lizard." },{ "name": "wizard", "file": "HumanMage2", "desc": "A powerful looking wizard." } ], "room": "Chest room", "things": "yourself, lizard and wizard", "party": "fighter and mage", "directions": "north, south, east and west", "actions": "look, go, identify, damage", "choices": "0" }}}
The lizard hits the fighter for 1 point of damage!
The wizard hits the fighter for 1 point of damage!

* * *

I beg your pardon?

>x self
 Fighter 
 Stats: 10 HP, 1 STR, 0 INT. 
 Inventory: +0 {Short Sword}. 

 Mage 
 Stats: 5 HP, 0 STR, 1 INT. 
 Inventory: {+2} {Pink Spellbook} of {Fire}.

{{{"images": [ ], "room": "Entrance", "things": "yourself and doorway", "party": "Fighter and Mage", "directions": "north and west", "actions": "look, go, identify, damage", "choices": "0" }}}

I beg your pardon?

>id self
 Fighter 
 Stats: 10 HP, 1 STR, 0 INT. 
 Inventory: +0 {Short Sword}. 

 Mage 
 Stats: 5 HP, 0 STR, 1 INT. 
 Inventory: {+2} {Pink Spellbook} of {Fire}.

{{{"images": [ ], "room": "Entrance", "things": "yourself and doorway", "party": "Fighter and Mage", "directions": "north and west", "actions": "look, go, identify, damage", "choices": "0" }}}

* * *

I beg your pardon?

>l
Entrance
As you enter the dungeon, the doorway shuts and is sealed tight by a magical force. To the west is the chest room. To the north there is a shop.

{{{"images": [ ], "room": "Entrance", "things": "yourself and doorway", "party": "Fighter and Mage", "directions": "north and west", "actions": "look, go, identify, damage", "choices": [ ] }}}

* * *

>n
You can't go that way.

{{{"images": [{ "name": "merchant", "file": "HumanThief2", "desc": "You don't want to mess with this guy." } ], "room": "Shop", "things": "yourself, merchant, Red Potion and Yellow Potion", "party": "Fighter and Mage", "directions": "south", "actions": "look, go, identify, damage", "choices": [ { "name": "c1", "desc": "Take the Red Potion" },{ "name": "c2", "desc": "Take the Yellow Potion" }] }}}

>damage merchant by 10
The merchant takes 10 damage.
The merchant is enraged by your unprovoked attack!
The merchant has been slain!
The merchant dropped Red Potion and Yellow PotionThe Fighter picks up {Red Potion}.
The Fighter picks up {Yellow Potion}.

{{{"images": [ ], "room": "Shop", "things": "yourself", "party": "Fighter and Mage", "directions": "south", "actions": "look, go, identify, damage", "choices": [ { "name": "c1", "desc": "Take the Red Potion" },{ "name": "c2", "desc": "Take the Yellow Potion" }] }}}

* * *

I beg your pardon?

>n
Shop
This is the shop. To the south is the entrance to the dungeon. There is a merchant here who is offering you a choice of items. Your party can only afford one. Will you buy the Red Potion or the Yellow Potion?

You can see a merchant here.

{{{"images": [{ "name": "merchant", "file": "HumanThief2", "desc": "You don't want to mess with this guy." } ], "room": "Shop", "things": "yourself, merchant, Red Potion and Yellow Potion", "party": "Fighter and Mage", "directions": "south", "actions": "look, go, identify, damage", "choices": [ { "name": "c1", "desc": "Take the Red Potion" },{ "name": "c2", "desc": "Take the Yellow Potion" }] }}}

>damage merchant by 10
The merchant takes 10 damage.
The merchant is enraged by your unprovoked attack!
The merchant has been slain!
The merchant dropped Red Potion and Yellow PotionThe Mage picks up {Red Potion}.
The Mage picks up {Yellow Potion}.

{{{"images": [ ], "room": "Shop", "things": "yourself", "party": "Fighter and Mage", "directions": "south", "actions": "look, go, identify, damage", "choices": [ { "name": "c1", "desc": "Take the Red Potion" },{ "name": "c2", "desc": "Take the Yellow Potion" }] }}}

* * *

Entrance
As you enter the dungeon, the doorway shuts and is sealed tight by a magical force. To the west is the chest room. To the north there is a shop.

>n
Shop
This is the shop. To the south is the entrance to the dungeon.

There is a merchant here who is offering you a choice of items. Your party can only afford one. Will you buy the Red Potion or the Yellow Potion?

{{{"images": [{ "name": "merchant", "file": "HumanThief2", "desc": "You don't want to mess with this guy." } ], "room": "Shop", "things": "yourself, merchant, Red Potion and Yellow Potion", "party": "Fighter and Mage", "directions": "south", "actions": "look, go, identify, damage", "choices": [ { "name": "c1", "desc": "Take the Red Potion" },{ "name": "c2", "desc": "Take the Yellow Potion" }] }}}

>x 1
whoa dude

{{{"images": [{ "name": "merchant", "file": "HumanThief2", "desc": "You don't want to mess with this guy." } ], "room": "Shop", "things": "yourself and merchant", "party": "Fighter and Mage", "directions": "south", "actions": "look, go, identify, damage", "choices": "1" }}}

* * *

>choose c2
The mage gets the {Yellow Potion}.

{{{"images": [{ "name": "merchant", "file": "HumanThief2", "desc": "You don't want to mess with this guy." } ], "room": "Shop", "things": "yourself, merchant, Red Potion and Yellow Potion", "party": "Fighter and Mage", "directions": "south", "actions": "look, go, identify, damage", "choices": [ ] }}}

>choose c1
You can't see any such thing.

>choose c2
You can't see any such thing.

>l
Shop
This is the shop. To the south is the entrance to the dungeon. The merchant is pleased with your choice.

You can see a merchant here.

{{{"images": [{ "name": "merchant", "file": "HumanThief2", "desc": "You don't want to mess with this guy." } ], "room": "Shop", "things": "yourself and merchant", "party": "Fighter and Mage", "directions": "south", "actions": "look, go, identify, damage", "choices": [ ] }}}

>restart
Are you sure you want to restart?

>y
 Fighter 
 Stats: 10 HP, 1 STR, 0 INT. 
 Inventory: +0 {Short Sword}. 

 Mage 
 Stats: 5 HP, 0 STR, 1 INT. 
 Inventory: {+2} {Pink Spellbook} of {Fire}.

{{{"images": [ ], "room": "Entrance", "things": "yourself and doorway", "party": "Fighter and Mage", "directions": "north and west", "actions": "look, go, identify, damage", "choices": [ ] }}}
It is written in the Book of Ishtar: 

 After the Creation, the cruel god Moloch rebelled against the authority of Marduk the Creator. Bla bla bla... 

 Who reads the stories anyway? Go get the Amulet of Yendor and come back out alive!

* * *

Entrance
As you enter the dungeon, the doorway shuts and is sealed tight by a magical force. To the west is the chest room. To the north there is a shop.

>n
Shop
This is the shop. To the south is the entrance to the dungeon. There is a merchant here who is offering you a choice of items. Your party can only afford one. Will you buy the Red Potion or the Yellow Potion?

You can see a merchant here.

{{{"images": [{ "name": "merchant", "file": "HumanThief2", "desc": "You don't want to mess with this guy." } ], "room": "Shop", "things": "yourself and merchant", "party": "Fighter and Mage", "directions": "south", "actions": "look, go, identify, damage", "choices": [ { "name": "c1", "desc": "Take the Red Potion" },{ "name": "c2", "desc": "Take the Yellow Potion" }] }}}

>choose c1
{{{"images": [{ "name": "merchant", "file": "HumanThief2", "desc": "You don't want to mess with this guy." } ], "room": "Shop", "things": "yourself and merchant", "party": "Fighter and Mage", "directions": "south", "actions": "look, go, identify, damage", "choices": [ ] }}}

* * *

>choose c2
The mage gets the {Yellow Potion}.

{{{"images": [{ "name": "merchant", "file": "HumanThief2", "desc": "You don't want to mess with this guy." } ], "room": "Shop", "things": "yourself, merchant, Red Potion and Yellow Potion", "party": "Fighter and Mage", "directions": "south", "actions": "look, go, identify, damage", "choices": [ ] }}}

>l
Shop
This is the shop. To the south is the entrance to the dungeon.

The merchant is pleased with your choice.

{{{"images": [{ "name": "merchant", "file": "HumanThief2", "desc": "You don't want to mess with this guy." } ], "room": "Shop", "things": "yourself, merchant, Red Potion and Yellow Potion", "party": "Fighter and Mage", "directions": "south", "actions": "look, go, identify, damage", "choices": [ ] }}}

>damage merchant by 10
The merchant takes 10 damage.
The merchant is enraged by your unprovoked attack!
The merchant has been slain!
The merchant dropped Red Potion.
The Mage picks up {Red Potion}.

{{{"images": [ ], "room": "Shop", "things": "yourself, Red Potion and Yellow Potion", "party": "Fighter and Mage", "directions": "south", "actions": "look, go, identify, damage", "choices": [ ] }}}

>l
Shop
This is the shop. To the south is the entrance to the dungeon.

{{{"images": [ ], "room": "Shop", "things": "yourself, Red Potion and Yellow Potion", "party": "Fighter and Mage", "directions": "south", "actions": "look, go, identify, damage", "choices": [ ] }}}

* * *

>choose c2
The mage gets the {Yellow Potion}.

{{{"images": [{ "name": "merchant", "file": "HumanThief2", "desc": "You don't want to mess with this guy." } ], "room": "Shop", "things": "yourself, merchant, Red Potion and Yellow Potion", "party": "Fighter and Mage", "directions": "south", "actions": "look, go, identify, damage", "choices": [ ] }}}

>damage merchant by 5
The merchant takes 5 damage.
The merchant is enraged by your unprovoked attack!

{{{"images": [{ "name": "merchant", "file": "HumanThief2", "desc": "You don't want to mess with this guy." } ], "room": "Shop", "things": "yourself, merchant, Red Potion and Yellow Potion", "party": "Fighter and Mage", "directions": "south", "actions": "look, go, identify, damage", "choices": [ ] }}}
{!} The merchant hits the Fighter for 2 points of damage!

>damage merchant by 5
The merchant takes 5 damage.
The merchant has been slain!
The merchant dropped Red Potion.
The Mage picks up {Red Potion}.
Well, that was one way of getting the other potion!

{{{"images": [ ], "room": "Shop", "things": "yourself, Red Potion and Yellow Potion", "party": "Fighter and Mage", "directions": "south", "actions": "look, go, identify, damage", "choices": [ ] }}}

* * *

>x merchant
You don't want to mess with this guy.

{{{"images": [{ "name": "merchant", "file": "HumanThief2", "desc": "You don't want to mess with this guy." } ], "room": "Shop", "things": "yourself and merchant", "party": "Fighter and Mage", "directions": "south", "actions": "look, go, identify, damage", "choices": [ { "name": "c2", "desc": "Take the Yellow Potion" }] }}}

* * *

>choose c1
The mage gets the {Red Potion}.

{{{"images": [{ "name": "merchant", "file": "HumanThief2", "desc": "You don't want to mess with this guy." } ], "room": "Shop", "things": "yourself and merchant", "party": "Fighter and Mage", "directions": "south", "actions": "look, go, identify, damage", "choices": [ { "name": "c1", "desc": "Take the Red Potion" },{ "name": "c2", "desc": "Take the Yellow Potion" }] }}}

* * *

>damage merchant by 10
The merchant takes 10 damage.
The merchant is enraged by your unprovoked attack!
The merchant has been slain!
The merchant dropped Red Potion and Yellow Potion.
The Mage picks up {Red Potion}.
The Mage picks up {Yellow Potion}.
he dead
{{{"images": [ ], "room": "Shop", "things": "yourself, Red Potion and Yellow Potion", "party": "Fighter and Mage", "directions": "south", "actions": "look, go, identify, damage", "choices": [ { "name": "c1", "desc": "Take the Red Potion" },{ "name": "c2", "desc": "Take the Yellow Potion" }] }}}

* * *

>damage merchant by 4
The merchant takes 4 damage.
The merchant is enraged by your unprovoked attack!

{{{"images": [{ "name": "merchant", "file": "HumanThief2", "desc": "You don't want to mess with this guy." } ], "room": "Shop", "things": "yourself, merchant, Red Potion and Yellow Potion", "party": "Fighter and Mage", "directions": "south", "actions": "look, go, identify, damage", "choices": [ { "name": "c1", "desc": "Take the Red Potion" },{ "name": "c2", "desc": "Take the Yellow Potion" }] }}}
{!} The merchant hits the Mage for 2 points of damage!

* * *

>d merchany by 100
That noun did not make sense in this context.

>damage merchany by 100
That noun did not make sense in this context.

>damage merchant by 100
The merchant takes 100 damage.
The merchant is enraged by your unprovoked attack!
The merchant has been slain!
The merchant dropped Red Potion and Yellow Potion.
The Mage picks up {Red Potion}.
The Mage picks up {Yellow Potion}.
he dead
{{{"images": [ ], "room": "Shop", "things": "yourself, Red Potion and Yellow Potion", "party": "Fighter and Mage", "directions": "south", "actions": "look, go, identify, damage", "choices": [ { "name": "c1", "desc": "Take the Red Potion" },{ "name": "c2", "desc": "Take the Yellow Potion" }] }}}

* * *

>damage merchant by 1
The merchant takes 1 damage.
The merchant is enraged by your unprovoked attack!

LOL
{{{"images": [{ "name": "merchant", "file": "HumanThief2", "desc": "You don't want to mess with this guy." } ], "room": "Shop", "things": "yourself, merchant, Red Potion and Yellow Potion", "party": "Fighter and Mage", "directions": "south", "actions": "look, go, identify, damage", "choices": [ { "name": "c1", "desc": "Take the Red Potion" },{ "name": "c2", "desc": "Take the Yellow Potion" }] }}}
{!} The merchant hits the Mage for 2 points of damage!

* * *

Entrance
As you enter the dungeon, the doorway shuts and is sealed tight by a magical force. To the west is the chest room. To the north there is a shop.

>e
You can't go that way.

{{{"images": [ ], "room": "Entrance", "things": "yourself and doorway", "party": "fighter and mage", "images": "", "directions": "north, south, east and west", "actions": "look, go, identify, damage", "choices": "0" }}}

>w
Chest room
The treasure chest calls to you. To the west is the entrance of this dungeon.

You can see a lizard and a wizard here.

{{{"images": { "name": "lizard", "image": "Lizard", "desc": "A weak looking lizard."  }, "room": "Chest room", "things": "yourself, lizard and wizard", "party": "fighter and mage", "images": "lizard", "directions": "north, south, east and west", "actions": "look, go, identify, damage", "choices": "0" }}}

* * *

>e
You can't go that way.

{{{"images": [ ], "room": "Entrance", "things": "yourself and doorway", "party": "fighter and mage", "images": "", "directions": "north, south, east and west", "actions": "look, go, identify, damage", "choices": "0" }}}

I beg your pardon?

>l
Entrance
As you enter the dungeon, the doorway shuts and is sealed tight by a magical force. To the west is the chest room. To the north there is a shop.

{{{"images": [ ], "room": "Entrance", "things": "yourself and doorway", "party": "fighter and mage", "images": "", "directions": "north, south, east and west", "actions": "look, go, identify, damage", "choices": "0" }}}

>w
Chest room
The treasure chest calls to you. To the west is the entrance of this dungeon.

You can see a lizard and a wizard here.

{{{"images": [{ "name": "lizard", "file": "Lizard", "desc": "A weak looking lizard." } ], "room": "Chest room", "things": "yourself, lizard and wizard", "party": "fighter and mage", "images": "lizard", "directions": "north, south, east and west", "actions": "look, go, identify, damage", "choices": "0" }}}

* * *

Entrance
As you enter the dungeon, the doorway shuts and is sealed tight by a magical force. To the west is the chest room. To the north there is a shop.

>w
Chest room
The treasure chest calls to you. To the west is the entrance of this dungeon.

You can see a lizard and a wizard here.

{{{"images": [{ "name": "lizard", "file": "LizardRed", "desc": "A weak looking lizard." },{ "name": "wizard", "file": "HumanMage2", "desc": "A powerful looking wizard." } ], "room": "Chest room", "things": "yourself, lizard and wizard", "party": "fighter and mage", "directions": "north, south, east and west", "actions": "look, go, identify, damage", "choices": "0" }}}
The lizard hits the mage for 1 point of damage!

>damage wizard by 1
The wizard takes 1 damage.
The wizard is enraged by your unprovoked attack!

{{{"images": [{ "name": "lizard", "file": "LizardRed", "desc": "A weak looking lizard." },{ "name": "wizard", "file": "HumanMage2", "desc": "A powerful looking wizard." } ], "room": "Chest room", "things": "yourself, lizard and wizard", "party": "fighter and mage", "directions": "north, south, east and west", "actions": "look, go, identify, damage", "choices": "0" }}}
The lizard hits the fighter for 1 point of damage!
The wizard hits the fighter for 1 point of damage!

>w
You can't go there because a lizard and a wizard are attacking you!

{{{"images": [{ "name": "lizard", "file": "LizardRed", "desc": "A weak looking lizard." },{ "name": "wizard", "file": "HumanMage2", "desc": "A powerful looking wizard." } ], "room": "Chest room", "things": "yourself, lizard and wizard", "party": "fighter and mage", "directions": "north, south, east and west", "actions": "look, go, identify, damage", "choices": "0" }}}
The lizard hits the mage for 1 point of damage!
The wizard hits the mage for 1 point of damage!

* * *

>damage wizard by 1
The wizard takes 1 damage.
The wizard is enraged by your unprovoked attack!

{{{"images": [{ "name": "lizard", "file": "LizardRed", "desc": "A weak looking lizard." },{ "name": "wizard", "file": "HumanMage2", "desc": "A powerful looking wizard." } ], "room": "Chest room", "things": "yourself, lizard and wizard", "party": "fighter and mage", "directions": "north, south, east and west", "actions": "look, go, identify, damage", "choices": "0" }}}
The lizard hits the fighter for 1 point of damage!
The wizard hits the fighter for 1 point of damage!

>e
You can't go there because a lizard and a wizard is attacking you!

{{{"images": [{ "name": "lizard", "file": "LizardRed", "desc": "A weak looking lizard." },{ "name": "wizard", "file": "HumanMage2", "desc": "A powerful looking wizard." } ], "room": "Chest room", "things": "yourself, lizard and wizard", "party": "fighter and mage", "directions": "north, south, east and west", "actions": "look, go, identify, damage", "choices": "0" }}}
The lizard hits the mage for 1 point of damage!
The wizard hits the mage for 1 point of damage!

* * *

>w
Chest room
The treasure chest calls to you. To the west is the entrance of this dungeon.

You can see a lizard and a wizard here.

{{{"images": [{ "name": "lizard", "file": "LizardRed", "desc": "A weak looking lizard." },{ "name": "wizard", "file": "HumanMage2", "desc": "A powerful looking wizard." } ], "room": "Chest room", "things": "yourself, lizard and wizard", "party": "fighter and mage", "directions": "north, south, east and west", "actions": "look, go, identify, damage", "choices": "0" }}}
The lizard hits the mage for 1 point of damage!

I beg your pardon?

* * *

>w
Chest room
The treasure chest calls to you. To the west is the entrance of this dungeon.

You can see a lizard and a wizard here.

{{{"images": [{ "name": "lizard", "file": "LizardRed", "desc": "A weak looking lizard." },{ "name": "wizard", "file": "HumanMage2", "desc": "A powerful looking wizard." } ], "room": "Chest room", "things": "yourself, lizard and wizard", "party": "fighter and mage", "directions": "north, south, east and west", "actions": "look, go, identify, damage", "choices": "0" }}}
The lizard hits the mage for 1 point of damage!

>e
You can't go there because the lizard are attacking you!

{{{"images": [{ "name": "lizard", "file": "LizardRed", "desc": "A weak looking lizard." },{ "name": "wizard", "file": "HumanMage2", "desc": "A powerful looking wizard." } ], "room": "Chest room", "things": "yourself, lizard and wizard", "party": "fighter and mage", "directions": "north, south, east and west", "actions": "look, go, identify, damage", "choices": "0" }}}
The lizard hits the mage for 1 point of damage!

* * *

Entrance
As you enter the dungeon, the doorway shuts and is sealed tight by a magical force. To the west is the chest room. To the north there is a shop.

>g n
You can hardly repeat that.

>go n
Shop
This is the shop. To the south is the entrance of the dungeon. There is a merchant here who is offering you a choice of items. Your party can only afford one. Will you buy the red potion or the yellow potion?

You can see a merchant here.

{{{"images": [{ "name": "merchant", "file": "HumanThief2", "desc": "You don't want to mess with this guy." } ], "room": "Shop", "things": "yourself and merchant", "party": "Fighter and Mage", "directions": "south", "actions": "look, go, identify, damage", "choices": "2" }}}

* * *

Entrance
As you enter the dungeon, the doorway shuts and is sealed tight by a magical force. To the west is the chest room. To the north there is a shop.

>id around
That noun did not make sense in this context.

* * *

Entrance
As you enter the dungeon, the doorway shuts and is sealed tight by a magical force. To the west is the chest room. To the north there is a shop.

>choose
You can't see any such thing.

>choose 1
You can't see any such thing.

>n
Shop
This is the shop. To the south is the entrance of the dungeon. There is a merchant here who is offering you a choice of items. Your party can only afford one. Will you buy the Red Potion or the Yellow Potion?

You can see a merchant here.

{{{"images": [{ "name": "merchant", "file": "HumanThief2", "desc": "You don't want to mess with this guy." } ], "room": "Shop", "things": "yourself and merchant", "party": "Fighter and Mage", "directions": "south", "actions": "look, go, identify, damage", "choices": "1 and 2" }}}

>choose 1
{{{"images": [{ "name": "merchant", "file": "HumanThief2", "desc": "You don't want to mess with this guy." } ], "room": "Shop", "things": "yourself and merchant", "party": "Fighter and Mage", "directions": "south", "actions": "look, go, identify, damage", "choices": "1 and 2" }}}

>x 1
Take the Red Potion

{{{"images": [{ "name": "merchant", "file": "HumanThief2", "desc": "You don't want to mess with this guy." } ], "room": "Shop", "things": "yourself and merchant", "party": "Fighter and Mage", "directions": "south", "actions": "look, go, identify, damage", "choices": "1 and 2" }}}

* * *

Entrance
As you enter the dungeon, the doorway shuts and is sealed tight by a magical force. To the west is the chest room. To the north there is a shop.

>choose c1
You can't see any such thing.

>n
Shop
This is the shop. To the south is the entrance of the dungeon. There is a merchant here who is offering you a choice of items. Your party can only afford one. Will you buy the Red Potion or the Yellow Potion?

You can see a merchant here.

{{{"images": [{ "name": "merchant", "file": "HumanThief2", "desc": "You don't want to mess with this guy." } ], "room": "Shop", "things": "yourself and merchant", "party": "Fighter and Mage", "directions": "south", "actions": "look, go, identify, damage", "choices": [ { "name": "c1", "desc": "Take the Red Potion" },{ "name": "c2", "desc": "Take the Yellow Potion" }] }}}

>choose c1
you get the {Red Potion}
{{{"images": [{ "name": "merchant", "file": "HumanThief2", "desc": "You don't want to mess with this guy." } ], "room": "Shop", "things": "yourself and merchant", "party": "Fighter and Mage", "directions": "south", "actions": "look, go, identify, damage", "choices": [ { "name": "c1", "desc": "Take the Red Potion" },{ "name": "c2", "desc": "Take the Yellow Potion" }] }}}

>choose c2
you get the {Yellow Potion}
{{{"images": [{ "name": "merchant", "file": "HumanThief2", "desc": "You don't want to mess with this guy." } ], "room": "Shop", "things": "yourself and merchant", "party": "Fighter and Mage", "directions": "south", "actions": "look, go, identify, damage", "choices": [ { "name": "c1", "desc": "Take the Red Potion" },{ "name": "c2", "desc": "Take the Yellow Potion" }] }}}

* * *

Entrance
As you enter the dungeon, the doorway shuts and is sealed tight by a magical force. To the west is the chest room. To the north there is a shop.

>g w
You can hardly repeat that.

>w
Chest room
The treasure chest calls to you. To the west is the entrance of this dungeon.

A weak looking lizard.

You can also see a wizard here.

{{{"images": [{ "name": "lizard", "file": "LizardRed", "desc": "" },{ "name": "wizard", "file": "HumanMage2", "desc": "A powerful looking wizard." } ], "room": "Chest room", "things": "yourself, lizard and wizard", "party": "Fighter and Mage", "directions": "east", "actions": "look, go, identify, damage", "choices": [ ] }}}
{!} The lizard hits the Fighter for 1 point of damage!

* * *

Entrance
As you enter the dungeon, the doorway shuts and is sealed tight by a magical force. To the west is the chest room. To the north there is a shop.

>id north
You see nothing unexpected in that direction.

{{{"images": [ ], "room": "Entrance", "things": "yourself and doorway", "party": "Fighter and Mage", "directions": "north and west", "actions": "look, go, identify, damage", "choices": [ ] }}}

I beg your pardon?

* * *

 Fighter 
 Stats: 10 HP, 1 STR, 0 INT. 
 Inventory: {Short Sword} of {Attack}. 

 Mage 
 Stats: 5 HP, 0 STR, 1 INT. 
 Inventory: {+2} {Pink Spellbook} of {Fire}.

>take lizard
Taken.

{{{things: "yourself and floor"}}}
{{{directions: "north, south, east and west"}}}
{{{actions: "take, identify"}}}

>dorp lizard
That's not a verb I recognise.

>drop lizard
Dropped.

{{{things: "Lizard, yourself and floor"}}}
{{{directions: "north, south, east and west"}}}
{{{actions: "take, identify"}}}

* * *

 Fighter 
 Stats: 10 HP, 1 STR, 0 INT. 
 Inventory: {Short Sword} of {Attack}. 

 Mage 
 Stats: 5 HP, 0 STR, 1 INT. 
 Inventory: {+2} {Pink Spellbook} of {Fire}.

>id lizard
A weak looking Lizard. 5/5 HP 0 STR 0 INT
{{{things: "yourself, lizard and floor"}}}
{{{directions: "north, south, east and west"}}}
{{{actions: "go, take, identify, examine, damage"}}}

>id north
You see nothing unexpected in that direction.

{{{things: "yourself, lizard and floor"}}}
{{{directions: "north, south, east and west"}}}
{{{actions: "go, take, identify, examine"}}}

* * *

>id lizard
A weak looking Lizard. 5/5 HP 0 STR 0 INT
{{{things: "yourself, lizard and floor"}}}
{{{directions: "north, south, east and west"}}}
{{{actions: "go, take, identify, examine, damage"}}}

>damage lizard
{{{things: "yourself, lizard and floor"}}}
{{{directions: "north, south, east and west"}}}
{{{actions: "go, take, identify, examine, damage"}}}

>id lizard
A weak looking Lizard. 4/5 HP 0 STR 0 INT
{{{things: "yourself, lizard and floor"}}}
{{{directions: "north, south, east and west"}}}
{{{actions: "go, take, identify, examine, damage"}}}

* * *

 Fighter 
 Stats: 10 HP, 1 STR, 0 INT. 
 Inventory: {Short Sword} of {Attack}. 

 Mage 
 Stats: 5 HP, 0 STR, 1 INT. 
 Inventory: {+2} {Pink Spellbook} of {Fire}.

>go north
Room2
{{{things: "yourself, lizard and floor"}}}
{{{directions: "north, south, east and west"}}}
{{{actions: "take, identify, examine"}}}

>s
Entrance
This is the only real room in the world. welcome.

You can see a lizard here.

{{{things: "yourself, lizard and floor"}}}
{{{directions: "north, south, east and west"}}}
{{{actions: "take, identify, examine"}}}

>n
Room2
{{{things: "yourself, lizard and floor"}}}
{{{directions: "north, south, east and west"}}}
{{{actions: "take, identify, examine"}}}

>x lizard
You can't see any such thing.

* * *

 Fighter 
 Stats: 10 HP, 1 STR, 0 INT. 
 Inventory: {Short Sword} of {Attack}. 

 Mage 
 Stats: 5 HP, 0 STR, 1 INT. 
 Inventory: {+2} {Pink Spellbook} of {Fire}.

>id self
As good-looking as ever.

{{{ "room": "Entrance", "things": "yourself, lizard, wizard and big door", "directions": "north, south, east, west and Around", "actions": "look, go, take, identify, damage", "choices": "0" }}}

>id lizard
A weak looking Lizard. 5/5 HP 0 STR 0 INT
{{{things: "yourself, lizard and floor"}}}
{{{directions: "north, south, east and west"}}}
{{{actions: "go, take, identify, examine"}}}

>id north
That noun did not make sense in this context.

* * *

>id self
As good-looking as ever.

{{{ "room": "Entrance", "things": "yourself, lizard, wizard and big door", "directions": "north, south, east, west and Around", "actions": "look, go, take, identify, damage", "choices": "0" }}}

>x north
You see nothing unexpected in that direction.

{{{ "room": "Entrance", "things": "yourself, lizard, wizard and big door", "directions": "north, south, east, west and Around", "actions": "look, go, take, identify, damage", "choices": "0" }}}

* * *

 Fighter 
 Stats: 10 HP, 1 STR, 0 INT. 
 Inventory: {Short Sword} of {Attack}. 

 Mage 
 Stats: 5 HP, 0 STR, 1 INT. 
 Inventory: {+2} {Pink Spellbook} of {Fire}.

>id north
You can't see any such thing.

>x north
You see nothing unexpected in that direction.

{{{things: "yourself, lizard and floor"}}}
{{{directions: "north, south, east and west"}}}
{{{actions: "go, take, identify, examine"}}}

>id thief
That noun did not make sense in this context.

* * *

>id north
You can't see any such thing.

>id
What do you want to id?

>id lizard
A weak looking Lizard. 5/5 HP 0 STR 0 INTA weak looking Lizard.
{{{things: "yourself, lizard and floor"}}}
{{{directions: "north, south, east and west"}}}
{{{actions: "go, take, identify, examine"}}}

>id lizard
A weak looking Lizard. 5/5 HP 0 STR 0 INTA weak looking Lizard.
{{{things: "yourself, lizard and floor"}}}
{{{directions: "north, south, east and west"}}}
{{{actions: "go, take, identify, examine"}}}

* * *

>id north
You can't see any such thing.

>id lizard
A weak looking Lizard. 5/5 HP 0 STR 0 INT
{{{things: "yourself, lizard and floor"}}}
{{{directions: "north, south, east and west"}}}
{{{actions: "go, take, identify, examine"}}}

>id north
You can't see any such thing.

* * *

 Fighter 
 Stats: 10 HP, 1 STR, 0 INT. 
 Inventory: {Short Sword} of {Attack}. 

 Mage 
 Stats: 5 HP, 0 STR, 1 INT. 
 Inventory: {+2} {Pink Spellbook} of {Fire}.

>x north
You see nothing unexpected in that direction.

{{{things: "yourself, lizard and floor"}}}
{{{directions: "north, south, east and west"}}}
{{{actions: "go, take, identify, examine"}}}

>id north
*** Run-time problem P10: Since the north is not allowed the property "description", it is against the rules to try to use it.

{{{things: "yourself, lizard and floor"}}}
{{{directions: "north, south, east and west"}}}
{{{actions: "go, take, identify, examine"}}}

* * *

 Fighter 
 Stats: 10 HP, 1 STR, 0 INT. 
 Inventory: {Short Sword} of {Attack}. 

 Mage 
 Stats: 5 HP, 0 STR, 1 INT. 
 Inventory: {+2} {Pink Spellbook} of {Fire}.

>damage lizard
I didn't understand that sentence.

>damage lizard
{{{things: "yourself, lizard and floor"}}}
{{{directions: "north, south, east and west"}}}
{{{actions: "go, take, identify, examine, damage"}}}

>damage lizard
{{{things: "yourself, lizard and floor"}}}
{{{directions: "north, south, east and west"}}}
{{{actions: "go, take, identify, examine, damage"}}}

>damage lizard
You killed the lizard!

{{{things: "yourself and floor"}}}
{{{directions: "north, south, east and west"}}}
{{{actions: "go, take, identify, examine, damage"}}}

>l
Entrance
This is the only real room in the world. welcome.

{{{things: "yourself and floor"}}}
{{{directions: "north, south, east and west"}}}
{{{actions: "go, take, identify, examine, damage"}}}

>x lizard
You can't see any such thing.

>l
Entrance
This is the only real room in the world. welcome.

{{{things: "yourself and floor"}}}
{{{directions: "north, south, east and west"}}}
{{{actions: "go, take, identify, examine, damage"}}}

* * *

>damage lizard
I didn't understand that sentence.

>damage lizard by 6
{{{things: "yourself, lizard and floor"}}}
{{{directions: "north, south, east and west"}}}
{{{actions: "go, take, identify, examine, damage"}}}

>id lizard
A weak looking Lizard. 5/5 HP 0 STR 0 INT
{{{things: "yourself, lizard and floor"}}}
{{{directions: "north, south, east and west"}}}
{{{actions: "go, take, identify, examine, damage"}}}

* * *

 Fighter 
 Stats: 10 HP, 1 STR, 0 INT. 
 Inventory: {Short Sword} of {Attack}. 

 Mage 
 Stats: 5 HP, 0 STR, 1 INT. 
 Inventory: {+2} {Pink Spellbook} of {Fire}.

>damage lizard by 6
You killed the lizard!

{{{things: "yourself and floor"}}}
{{{directions: "north, south, east and west"}}}
{{{actions: "go, take, identify, examine, damage"}}}

>id lizard
A weak looking Lizard. 5/5 HP 0 STR 0 INT
{{{things: "yourself, lizard and floor"}}}
{{{directions: "north, south, east and west"}}}
{{{actions: "go, take, identify, examine, damage"}}}

* * *

 Fighter 
 Stats: 10 HP, 1 STR, 0 INT. 
 Inventory: {Short Sword} of {Attack}. 

 Mage 
 Stats: 5 HP, 0 STR, 1 INT. 
 Inventory: {+2} {Pink Spellbook} of {Fire}.

>damage lizard by 5
You killed the lizard!

{{{things: "yourself and floor"}}}
{{{directions: "north, south, east and west"}}}
{{{actions: "go, take, identify, examine, damage"}}}

* * *

 Fighter 
 Stats: 10 HP, 1 STR, 0 INT. 
 Inventory: {Short Sword} of {Attack}. 

 Mage 
 Stats: 5 HP, 0 STR, 1 INT. 
 Inventory: {+2} {Pink Spellbook} of {Fire}.

>x target
You can't see any such thing.

>x
(the lizard)
A weak looking Lizard.

{{{things: "yourself, lizard and floor"}}}
{{{directions: "north, south, east and west"}}}
{{{actions: "go, take, identify, examine, damage"}}}

>d
You can't go that way.

{{{things: "yourself, lizard and floor"}}}
{{{directions: "north, south, east and west"}}}
{{{actions: "go, take, identify, examine, damage"}}}

* * *

>x target
You can't see any such thing.

>x self
As good-looking as ever.

{{{ "room": "Entrance", "things": "yourself, lizard, wizard and big door", "directions": "north, south, east, west and Around", "actions": "look, go, take, identify, damage", "choices": "0" }}}

>id self
As good-looking as ever.

{{{ "room": "Entrance", "things": "yourself, lizard, wizard and big door", "directions": "north, south, east, west and Around", "actions": "look, go, take, identify, damage", "choices": "0" }}}

>id north
You see nothing unexpected in that direction.

{{{ "room": "Entrance", "things": "yourself, lizard, wizard and big door", "directions": "north, south, east, west and Around", "actions": "look, go, take, identify, damage", "choices": "0" }}}

>id around
You see nothing unexpected in that direction.

{{{ "room": "Entrance", "things": "yourself, lizard, wizard and big door", "directions": "north, south, east, west and Around", "actions": "look, go, take, identify, damage", "choices": "0" }}}

* * *

 Fighter 
 Stats: 10 HP, 1 STR, 0 INT. 
 Inventory: {Short Sword} of {Attack}. 

 Mage 
 Stats: 5 HP, 0 STR, 1 INT. 
 Inventory: {+2} {Pink Spellbook} of {Fire}.

>d
I didn't understand that sentence.

>d north by 4
That noun did not make sense in this context.

>damage self
I didn't understand that sentence.

>damage self by 1
{{{things: "yourself, lizard and floor"}}}
{{{directions: "north, south, east and west"}}}
{{{actions: "go, take, identify, examine, damage"}}}

>id self
As good-looking as ever.
{{{things: "yourself, lizard and floor"}}}
{{{directions: "north, south, east and west"}}}
{{{actions: "go, take, identify, examine, damage"}}}

* * *

 Fighter 
 Stats: 10 HP, 1 STR, 0 INT. 
 Inventory: {Short Sword} of {Attack}. 

 Mage 
 Stats: 5 HP, 0 STR, 1 INT. 
 Inventory: {+2} {Pink Spellbook} of {Fire}.

>id floor
The floor is melting...
{{{things: "yourself, lizard and floor"}}}
{{{directions: "north, south, east and west"}}}
{{{actions: "go, take, identify, examine, damage"}}}

* * *

 Fighter 
 Stats: 10 HP, 1 STR, 0 INT. 
 Inventory: {Short Sword} of {Attack}. 

 Mage 
 Stats: 5 HP, 0 STR, 1 INT. 
 Inventory: {+2} {Pink Spellbook} of {Fire}.

>damage wizard by 3
The wizard is angered by your unprovoked attack!

{{{things: "yourself, lizard, wizard and floor"}}}
{{{directions: "north, south, east and west"}}}
{{{actions: "go, take, identify, examine, damage"}}}

>damage wizard by 3
{{{things: "yourself, lizard, wizard and floor"}}}
{{{directions: "north, south, east and west"}}}
{{{actions: "go, take, identify, examine, damage"}}}

>damage wizard by 3
{{{things: "yourself, lizard, wizard and floor"}}}
{{{directions: "north, south, east and west"}}}
{{{actions: "go, take, identify, examine, damage"}}}

>damage wizard by 3
You killed the wizard!

{{{things: "yourself, lizard and floor"}}}
{{{directions: "north, south, east and west"}}}
{{{actions: "go, take, identify, examine, damage"}}}

* * *

 Fighter 
 Stats: 10 HP, 1 STR, 0 INT. 
 Inventory: {Short Sword} of {Attack}. 

 Mage 
 Stats: 5 HP, 0 STR, 1 INT. 
 Inventory: {+2} {Pink Spellbook} of {Fire}.

>id wizard
A powerful looking wizard. 10/10 HP 0 STR 0 INT
{{{things: "yourself, lizard, wizard and floor"}}}
{{{directions: "north, south, east and west"}}}
{{{actions: "go, take, identify, examine, damage"}}}

* * *

 Fighter 
 Stats: 10 HP, 1 STR, 0 INT. 
 Inventory: {Short Sword} of {Attack}. 

 Mage 
 Stats: 5 HP, 0 STR, 1 INT. 
 Inventory: {+2} {Pink Spellbook} of {Fire}.

>n
{{{"images": [ ], "room": "Entrance", "things": "yourself and doorway", "party": "Fighter and Mage", "directions": "north and west", "actions": "look, go, identify, damage", "choices": [ ] }}}
It is written in the Book of Ishtar: 

 After the Creation, the cruel god Moloch rebelled against the authority of Marduk the Creator. Bla bla bla... 

 Who reads the stories anyway? Go get the Amulet of Yendor and come back out alive!

>1
The mage now has a red potion.

>1
That wasn't one of the choices.

The mage now has a red potion.

>1
That wasn't one of the choices.

The mage now has a red potion.

* * *

>n
{{{"images": [ ], "room": "Entrance", "things": "yourself and doorway", "party": "Fighter and Mage", "directions": "north and west", "actions": "look, go, identify, damage", "choices": [ ] }}}
It is written in the Book of Ishtar: 

 After the Creation, the cruel god Moloch rebelled against the authority of Marduk the Creator. Bla bla bla... 

 Who reads the stories anyway? Go get the Amulet of Yendor and come back out alive!

>x merchant
You don't want to mess with this guy.

{{{things: "yourself, lizard, wizard, floor and merchant"}}}
{{{directions: "north, south, east and west"}}}
{{{actions: "go, take, identify, examine, damage"}}}
{{{choices: "0"}}}

>id merchant
You don't want to mess with this guy. 10/10 HP 0 STR 0 INT
{{{things: "yourself, lizard, wizard, floor and merchant"}}}
{{{directions: "north, south, east and west"}}}
{{{actions: "go, take, identify, examine, damage"}}}
{{{choices: "0"}}}

* * *

>n
{{{"images": [ ], "room": "Entrance", "things": "yourself and doorway", "party": "Fighter and Mage", "directions": "north and west", "actions": "look, go, identify, damage", "choices": [ ] }}}
It is written in the Book of Ishtar: 

 After the Creation, the cruel god Moloch rebelled against the authority of Marduk the Creator. Bla bla bla... 

 Who reads the stories anyway? Go get the Amulet of Yendor and come back out alive!

>s
Entrance
As you enter the dungeon, the doorway behind disappears.

You can see a lizard and a wizard here.

{{{ room: "Entrance", things: "yourself, lizard, wizard and big door", directions: "north, south, east and west", actions: "go, take, identify, examine, damage", choices: "2", }}}

I beg your pardon?

>n
{{{ room: "Shop", things: "yourself and merchant", directions: "north, south, east and west", actions: "go, take, identify, examine, damage", choices: "2", }}}

* * *

>n
{{{"images": [ ], "room": "Entrance", "things": "yourself and doorway", "party": "Fighter and Mage", "directions": "north and west", "actions": "look, go, identify, damage", "choices": [ ] }}}
It is written in the Book of Ishtar: 

 After the Creation, the cruel god Moloch rebelled against the authority of Marduk the Creator. Bla bla bla... 

 Who reads the stories anyway? Go get the Amulet of Yendor and come back out alive!

>l
Shop
There is a merchant here who is offering you a choice of items. Your party can only afford one. Will you buy the red potion or the yellow potion?yourself

You can see a merchant here.

* * *

>n
{{{"images": [ ], "room": "Entrance", "things": "yourself and doorway", "party": "Fighter and Mage", "directions": "north and west", "actions": "look, go, identify, damage", "choices": [ ] }}}
It is written in the Book of Ishtar: 

 After the Creation, the cruel god Moloch rebelled against the authority of Marduk the Creator. Bla bla bla... 

 Who reads the stories anyway? Go get the Amulet of Yendor and come back out alive!

>n
Entrance
As you enter the dungeon, the doorway shuts and is sealed tight by a magical force. To the west is the chest room. To the north there is a shop.

>n
Shop
This is the shop. To the south is the entrance to the dungeon. There is a merchant here who is offering you a choice of items. Your party can only afford one. Will you buy the Red Potion or the Yellow Potion?

You can see a merchant here.

{{{"images": [{ "name": "merchant", "file": "HumanThief2", "desc": "You don't want to mess with this guy." } ], "room": "Shop", "things": "yourself, merchant, Red Potion and Yellow Potion", "party": "Fighter and Mage", "directions": "south", "actions": "look, go, identify, damage", "choices": [ { "name": "c1", "desc": "Take the Red Potion" },{ "name": "c2", "desc": "Take the Yellow Potion" }] }}}

>s
Entrance
As you enter the dungeon, the doorway shuts and is sealed tight by a magical force. To the west is the chest room. To the north there is a shop.

{{{"images": [ ], "room": "Entrance", "things": "yourself and doorway", "party": "Fighter and Mage", "directions": "north and west", "actions": "look, go, identify, damage", "choices": [ ] }}}

>w
Chest room
The treasure chest calls to you. To the west is the entrance of this dungeon.

You can see a lizard and a wizard here.

{{{"images": [{ "name": "lizard", "file": "LizardRed", "desc": "A weak looking lizard." },{ "name": "wizard", "file": "HumanMage2", "desc": "A powerful looking wizard." } ], "room": "Chest room", "things": "yourself, lizard and wizard", "party": "Fighter and Mage", "directions": "east", "actions": "look, go, identify, damage", "choices": [ ] }}}
{!} The lizard hits the Mage for 1 point of damage!

* * *

 Fighter 
 Stats: 10 HP, 1 STR, 0 INT. 
 Inventory: {Short Sword} of {Attack}. 

 Mage 
 Stats: 5 HP, 0 STR, 1 INT. 
 Inventory: {+2} {Pink Spellbook} of {Fire}.

>1
That wasn't one of the choices.

>2
{{{things: "yourself, lizard, wizard, floor and merchant"}}}
{{{directions: "north, south, east and west"}}}
{{{actions: "go, take, identify, examine, damage"}}}

* * *

>1
That wasn't one of the choices.

>n
Shop
There is a merchant here who is offering you a choice of items. Your party can only afford one. Will you buy the red potion or the yellow potion?

You can see a merchant here.

>1
The mage now has a red potion.

* * *

>1
That wasn't one of the choices.

The mage now has a red potion.

>l
Shop
There is a merchant here who is offering you a choice of items. Your party can only afford one. Will you buy the red potion or the yellow potion?

You can see a merchant here.

* * *

 Fighter 
 Stats: 10 HP, 1 STR, 0 INT. 
 Inventory: {Short Sword} of {Attack}. 

 Mage 
 Stats: 5 HP, 0 STR, 1 INT. 
 Inventory: {+2} {Pink Spellbook} of {Fire}.

>3
That wasn't one of the choices.

{{{things: "yourself, lizard, wizard and big door"}}}
{{{directions: "north, south, east and west"}}}
{{{actions: "go, take, identify, examine, damage"}}}
{{{choices: "0"}}}

>2
That wasn't one of the choices.

{{{things: "yourself, lizard, wizard and big door"}}}
{{{directions: "north, south, east and west"}}}
{{{actions: "go, take, identify, examine, damage"}}}
{{{choices: "0"}}}

I beg your pardon?

>1
That wasn't one of the choices.

{{{things: "yourself, lizard, wizard and big door"}}}
{{{directions: "north, south, east and west"}}}
{{{actions: "go, take, identify, examine, damage"}}}
{{{choices: "0"}}}

>m
I didn't understand that number.

>n
{{{things: "yourself and merchant"}}}
{{{directions: "north, south, east and west"}}}
{{{actions: "go, take, identify, examine, damage"}}}
{{{choices: "2"}}}

>l
Shop
There is a merchant here who is offering you a choice of items. Your party can only afford one. Will you buy the red potion or the yellow potion?

You can see a merchant here.

{{{things: "yourself and merchant"}}}
{{{directions: "north, south, east and west"}}}
{{{actions: "go, take, identify, examine, damage"}}}
{{{choices: "2"}}}

>2
The mage now has a yellow potion.

{{{things: "yourself and merchant"}}}
{{{directions: "north, south, east and west"}}}
{{{actions: "go, take, identify, examine, damage"}}}
{{{choices: "0"}}}

>l
Shop
There is a merchant here who is offering you a choice of items. Your party can only afford one. Will you buy the red potion or the yellow potion?

You can see a merchant here.

{{{things: "yourself and merchant"}}}
{{{directions: "north, south, east and west"}}}
{{{actions: "go, take, identify, examine, damage"}}}
{{{choices: "0"}}}

* * *

 Fighter 
 Stats: 10 HP, 1 STR, 0 INT. 
 Inventory: {Short Sword} of {Attack}. 

 Mage 
 Stats: 5 HP, 0 STR, 1 INT. 
 Inventory: {+2} {Pink Spellbook} of {Fire}.

>damage lizard by 1`
I didn't understand that number.

>damage lizard by 1
The lizard takes 1 damage.

{{{ room: "Entrance", things: "yourself, lizard, wizard and big door", directions: "north, south, east and west", actions: "go, take, identify, examine, damage", choices: "0", }}}

* * *

 Fighter 
 Stats: 10 HP, 1 STR, 0 INT. 
 Inventory: {Short Sword} of {Attack}. 

 Mage 
 Stats: 5 HP, 0 STR, 1 INT. 
 Inventory: {+2} {Pink Spellbook} of {Fire}.

>damage door by 1
The attack has no effect on the big door.

{{{ room: "Entrance", things: "yourself, lizard, wizard and big door", directions: "north, south, east and west", actions: "go, take, identify, examine, damage", choices: "0", }}}

>damage lizard by 1
The lizard takes 1 damage.

{{{ room: "Entrance", things: "yourself, lizard, wizard and big door", directions: "north, south, east and west", actions: "go, take, identify, examine, damage", choices: "0", }}}

* * *

 Fighter 
 Stats: 10 HP, 1 STR, 0 INT. 
 Inventory: {Short Sword} of {Attack}. 

 Mage 
 Stats: 5 HP, 0 STR, 1 INT. 
 Inventory: {+2} {Pink Spellbook} of {Fire}.

>x room
You can't see any such thing.

>x here
You can't see any such thing.

>look here
You can't see any such thing.

>look
Entrance
As you enter the dungeon, the doorway behind disappears.

You can see a lizard and a wizard here.

{{{ "room": "Entrance", "things": "yourself, lizard, wizard and big door", "directions": "north, south, east and west", "actions": "look, go, take, identify, damage", "choices": "0" }}}

>x the room
You can't see any such thing.

>x Entrance
You can't see any such thing.

>x Shop
You can't see any such thing.

>l
Entrance
As you enter the dungeon, the doorway behind disappears.

You can see a lizard and a wizard here.

{{{ "room": "Entrance", "things": "yourself, lizard, wizard and big door", "directions": "north, south, east and west", "actions": "look, go, take, identify, damage", "choices": "0" }}}

>l self
As good-looking as ever.

{{{ "room": "Entrance", "things": "yourself, lizard, wizard and big door", "directions": "north, south, east and west", "actions": "look, go, take, identify, damage", "choices": "0" }}}

* * *

 Fighter 
 Stats: 10 HP, 1 STR, 0 INT. 
 Inventory: {Short Sword} of {Attack}. 

 Mage 
 Stats: 5 HP, 0 STR, 1 INT. 
 Inventory: {+2} {Pink Spellbook} of {Fire}.

>look location
You can't see any such thing.

* * *

 Fighter 
 Stats: 10 HP, 1 STR, 0 INT. 
 Inventory: {Short Sword} of {Attack}. 

 Mage 
 Stats: 5 HP, 0 STR, 1 INT. 
 Inventory: {+2} {Pink Spellbook} of {Fire}.

>go here
You can't see any such thing.

>here
I didn't understand that number.

* * *

 Fighter 
 Stats: 10 HP, 1 STR, 0 INT. 
 Inventory: {Short Sword} of {Attack}. 

 Mage 
 Stats: 5 HP, 0 STR, 1 INT. 
 Inventory: {+2} {Pink Spellbook} of {Fire}.

>look around
Entrance
As you enter the dungeon, the doorway behind disappears.

You can see a lizard and a wizard here.

{{{ "room": "Entrance", "things": "yourself, lizard, wizard and big door", "directions": "north, south, east, west and around", "actions": "look, go, take, identify, damage", "choices": "0" }}}

>id self
As good-looking as ever.
{{{ "room": "Entrance", "things": "yourself, lizard, wizard and big door", "directions": "north, south, east, west and Around", "actions": "look, go, take, identify, damage", "choices": "0" }}}

* * *

>look around
Entrance
As you enter the dungeon, the doorway behind disappears.

You can see a lizard and a wizard here.

{{{ "room": "Entrance", "things": "yourself, lizard, wizard and big door", "directions": "north, south, east, west and around", "actions": "look, go, take, identify, damage", "choices": "0" }}}

>id around
Entrance
As you enter the dungeon, the doorway behind disappears.

You can see a lizard and a wizard here.

{{{ "room": "Entrance", "things": "yourself, lizard, wizard and big door", "directions": "north, south, east, west and Around", "actions": "look, go, take, identify, damage", "choices": "0" }}}

* * *

>look around
Entrance
As you enter the dungeon, the doorway behind disappears.

You can see a lizard and a wizard here.

{{{ "room": "Entrance", "things": "yourself, lizard, wizard and big door", "directions": "north, south, east, west and around", "actions": "look, go, take, identify, damage", "choices": "0" }}}

>go around
You can't go that way.

{{{ "room": "Entrance", "things": "yourself, lizard, wizard and big door", "directions": "north, south, east, west and around", "actions": "look, go, take, identify, damage", "choices": "0" }}}

* * *

Entrance
As you enter the dungeon, the doorway shuts and is sealed tight by a magical force. To the west is the chest room. To the north there is a shop.

>n
Shop
This is the shop. To the south is the entrance of the dungeon. There is a merchant here who is offering you a choice of items. Your party can only afford one. Will you buy the red potion or the yellow potion?

You can see a merchant here.

{{{"images": [{ "name": "merchant", "file": "HumanThief2", "desc": "You don't want to mess with this guy." } ], "room": "Shop", "things": "yourself and merchant", "party": "fighter and mage", "directions": "north, south, east and west", "actions": "look, go, identify, damage", "choices": "2" }}}

>s
Entrance
As you enter the dungeon, the doorway shuts and is sealed tight by a magical force. To the west is the chest room. To the north there is a shop.

{{{"images": [ ], "room": "Entrance", "things": "yourself and doorway", "party": "fighter and mage", "directions": "north, south, east and west", "actions": "look, go, identify, damage", "choices": "2" }}}

>w
Chest room
The treasure chest calls to you. To the west is the entrance of this dungeon.

You can see a lizard and a wizard here.

{{{"images": [{ "name": "lizard", "file": "LizardRed", "desc": "A weak looking lizard." },{ "name": "wizard", "file": "HumanMage2", "desc": "A powerful looking wizard." } ], "room": "Chest room", "things": "yourself, lizard and wizard", "party": "fighter and mage", "directions": "north, south, east and west", "actions": "look, go, identify, damage", "choices": "2" }}}

* * *

Entrance
As you enter the dungeon, the doorway shuts and is sealed tight by a magical force. To the west is the chest room. To the north there is a shop.

>go north
Shop
This is the shop. To the south is the entrance to the dungeon. There is a merchant here who is offering you a choice of items. Your party can only afford one. Will you buy the Red Potion or the Yellow Potion?

You can see a merchant here.

{{{"images": [{ "name": "merchant", "file": "HumanThief2", "desc": "You don't want to mess with this guy." } ], "room": "Shop", "things": "yourself, merchant, Red Potion and Yellow Potion", "party": "Fighter and Mage", "directions": "south", "actions": "look, go, identify, damage", "choices": [ { "name": "c1", "desc": "Take the Red Potion" },{ "name": "c2", "desc": "Take the Yellow Potion" }] }}}

>damage merchant by 100
The merchant takes 100 damage.
The merchant is enraged by your unprovoked attack!
The merchant has been slain!
The merchant dropped Red Potion and Yellow Potion.
The Mage picks up {Red Potion}.
The Fighter picks up {Yellow Potion}.

{{{"images": [ ], "room": "Shop", "things": "yourself, Red Potion and Yellow Potion", "party": "Fighter and Mage", "directions": "south", "actions": "look, go, identify, damage", "choices": [ ] }}}

>restart
Are you sure you want to restart?

>yes
 Fighter 
 Stats: 10 HP, 1 STR, 0 INT. 
 Inventory: {Short Sword} of {Attack}. 

 Mage 
 Stats: 5 HP, 0 STR, 1 INT. 
 Inventory: {+2} {Pink Spellbook} of {Fire}.

{{{"images": [ ], "room": "Entrance", "things": "yourself and doorway", "party": "Fighter and Mage", "directions": "north and west", "actions": "look, go, identify, damage", "choices": [ ] }}}
It is written in the Book of Ishtar: 

 After the Creation, the cruel god Moloch rebelled against the authority of Marduk the Creator. Bla bla bla... 

 Who reads the stories anyway? Go get the Amulet of Yendor and come back out alive!

* * *

Entrance
As you enter the dungeon, the doorway shuts and is sealed tight by a magical force. To the west is the chest room. To the north there is a shop.

>n
Shop
This is the shop. To the south is the entrance to the dungeon. There is a merchant here who is offering you a choice of items. Your party can only afford one. Will you buy the Red Potion or the Yellow Potion?

You can see a merchant here.

{{{"images": [{ "name": "merchant", "file": "HumanThief2", "desc": "You don't want to mess with this guy." } ], "room": "Shop", "things": "yourself, merchant, Red Potion and Yellow Potion", "party": "Fighter and Mage", "directions": "south", "actions": "look, go, identify, damage", "choices": [ { "name": "c1", "desc": "Take the Red Potion" },{ "name": "c2", "desc": "Take the Yellow Potion" }] }}}

>choose c1
The mage gets the {Red Potion}.

{{{"images": [{ "name": "merchant", "file": "HumanThief2", "desc": "You don't want to mess with this guy." } ], "room": "Shop", "things": "yourself, merchant, Red Potion and Yellow Potion", "party": "Fighter and Mage", "directions": "south", "actions": "look, go, identify, damage", "choices": [ ] }}}

>damage merchant by 100
The merchant takes 100 damage.
The merchant is enraged by your unprovoked attack!
The merchant has been slain!
The merchant dropped Yellow Potion.
The Fighter picks up {Yellow Potion}.

{{{"images": [ ], "room": "Shop", "things": "yourself, Red Potion and Yellow Potion", "party": "Fighter and Mage", "directions": "south", "actions": "look, go, identify, damage", "choices": [ ] }}}

* * *

 Fighter 
 Stats: 10 HP, 1 STR, 0 INT. 
 Inventory: {Short Sword} of {Attack}. 

 Mage 
 Stats: 5 HP, 0 STR, 1 INT. 
 Inventory: {+2} {Pink Spellbook} of {Fire}.

>w
It is written in the Book of Ishtar: 

 After the Creation, the cruel god Moloch rebelled against the authority of Marduk the Creator. Bla bla bla... 

 Who reads the stories anyway? Go get the Amulet of Yendor and come back out alive!

Entrance
As you enter the dungeon, the doorway shuts and is sealed tight by a magical force. To the west is the chest room. To the north there is a shop.

>w
Chest room
The treasure chest calls to you. To the west is the entrance of this dungeon.

You can see a lizard and a wizard here.

{{{"images": [{ "name": "lizard", "file": "LizardRed", "desc": "A weak looking lizard." },{ "name": "wizard", "file": "HumanMage2", "desc": "A powerful looking wizard." } ], "room": "Chest room", "things": "yourself, lizard and wizard", "party": "Fighter and Mage", "directions": "north, south, east and west", "actions": "look, go, identify, damage", "choices": "0" }}}
The lizard hits the Fighter for 1 point of damage!

>damage wizard by `
I didn't understand that number.

>damage wizard by 1
The wizard takes 1 damage.
The wizard is enraged by your unprovoked attack!

{{{"images": [{ "name": "lizard", "file": "LizardRed", "desc": "A weak looking lizard." },{ "name": "wizard", "file": "HumanMage2", "desc": "A powerful looking wizard." } ], "room": "Chest room", "things": "yourself, lizard and wizard", "party": "Fighter and Mage", "directions": "north, south, east and west", "actions": "look, go, identify, damage", "choices": "0" }}}
The lizard hits the Mage for 1 point of damage!
The wizard hits the Fighter for 1 point of damage!

* * *

 Fighter 
 Stats: 10 HP, 1 STR, 0 INT. 
 Inventory: {Short Sword} of {Attack}. 

 Mage 
 Stats: 5 HP, 0 STR, 1 INT. 
 Inventory: {+2} {Pink Spellbook} of {Fire}.

>i
Entrance
As you enter the dungeon, the doorway shuts and is sealed tight by a magical force. To the west is the chest room. To the north there is a shop.

>id self
 Fighter 
 Stats: 10 HP, 1 STR, 0 INT. 
 Inventory: +0 {Short Sword}. 

 Mage 
 Stats: 5 HP, 0 STR, 1 INT. 
 Inventory: {+2} {Pink Spellbook} of {Fire}. 

{{{"images": [ ], "room": "Entrance", "things": "yourself and doorway", "party": "Fighter and Mage", "directions": "north and west", "actions": "look, go, identify, damage", "choices": "0" }}}

>l
Entrance
As you enter the dungeon, the doorway shuts and is sealed tight by a magical force. To the west is the chest room. To the north there is a shop.

{{{"images": [ ], "room": "Entrance", "things": "yourself and doorway", "party": "Fighter and Mage", "directions": "north and west", "actions": "look, go, identify, damage", "choices": "0" }}}